[
  {
    "type": "mapgen",
    "method": "json",
    "om_terrain": [ "home_improvement" ],
    "weight": 10000,
    "object": {
      "fill_ter": "t_thconc_floor",
      "rows": [
        "           ,,           ",
        "           ,,           ",
        " ||||OO||||++||||OO|||| ",
        " |@@.@.@.@....c....???| ",
        " |@@.@........c.A....?| ",
        " |.....@.@.rr.c%ccc..?| ",
        " |.........rr.........| ",
        " |.........rr.........| ",
        " |:::::::::rryyyyyyyyy| ",
        " |.........rr.........| ",
        " |111111111rrLLLLLLLLL| ",
        " |HHHHHHHHHrrhhhhhAAAA| ",
        " |.........rr.........| ",
        " |SSSSSSSSSrr333xxxwww| ",
        " |222222222rrwww333xxx| ",
        " |.........rr.........O ",
        " ||+|||....rr.........O ",
        " |y.ll|####rr#########| ",
        " |I...|....rr.........| ",
        " |Ih.S|####rr#########| ",
        " |||+||...............| ",
        " |6..&|####..#########| ",
        " |||||||||||||||||||||| ",
        "         U<UU4          "
      ],
      "terrain": {
        "+": "t_door_c",
        " ": "t_region_groundcover_urban",
        ",": "t_concrete",
        "U": "t_concrete",
        ".": "t_thconc_floor",
        "O": "t_window",
        "r": "t_carpet_concrete_red",
        "|": "t_wall_w",
        "4": "t_gutter_downspout",
        "<": "t_ladder_up"
      },
      "furniture": {
        "%": "f_console_broken",
        "A": "f_stool",
        "3": "f_bookcase",
        "x": "f_entertainment_center",
        "w": "f_rack_wood",
        "U": [ "f_dumpster", "f_recycle_bin" ],
        "2": "f_rack_coat",
        "l": "f_locker",
        "I": "f_desk",
        "6": "f_sink",
        "h": "f_chair",
        "H": "f_armchair",
        "#": "f_rack",
        "c": "f_counter",
        ":": "f_dresser",
        "1": "f_wardrobe",
        "S": "f_filing_cabinet",
        "L": "f_floor_lamp",
        "?": "f_statue",
        "@": "f_bed",
        "y": [ "f_indoor_plant_y", "f_indoor_plant" ]
      },
      "toilets": { "&": {  } },
      "items": {
        "I": { "item": "office", "chance": 30 },
        "U": { "item": "trash", "chance": 20, "repeat": [ 2, 4 ] },
        "l": [ { "item": "jackets", "chance": 10 }, { "item": "bags", "chance": 10 } ]
      },
      "place_loot": [
        { "group": "paint", "x": [ 7, 10 ], "y": 17, "repeat": [ 2, 12 ] },
        { "group": "paint", "x": [ 7, 10 ], "y": 19, "repeat": [ 2, 12 ] },
        { "group": "paint", "x": [ 7, 10 ], "y": 21, "repeat": [ 2, 12 ] },
        { "group": "rug", "x": [ 13, 21 ], "y": 17, "repeat": [ 5, 25 ] },
        { "group": "rug", "x": [ 13, 21 ], "y": 19, "repeat": [ 5, 25 ] },
        { "item": "fake_grass", "x": [ 13, 21 ], "y": 21, "repeat": [ 5, 25 ] },
        { "group": "cash_register_random", "x": 14, "y": [ 3, 5 ] }
      ]
    }
  },
  {
    "type": "mapgen",
    "method": "json",
    "om_terrain": "home_improvement_roof",
    "object": {
      "fill_ter": "t_flat_roof",
      "rows": [
        "                        ",
        "                        ",
        " |222222222222222222223 ",
        " |....................3 ",
        " |....................3 ",
        " |....................3 ",
        " |....................3 ",
        " |....................3 ",
        " |....................3 ",
        " |....................3 ",
        " |....................3 ",
        " |....................3 ",
        " |....................3 ",
        " |....................3 ",
        " |....................3 ",
        " |....................3 ",
        " |....................3 ",
        " |....................3 ",
        " |....................3 ",
        " |....................3 ",
        " |....................3 ",
        " |....................3 ",
        " |------####-5--------3 ",
        "        ##>##           "
      ],
      "palettes": [ "roof_palette" ],
      "terrain": { ">": "t_ladder_down" },
      "place_nested": [
        {
          "chunks": [
            [ "null", 20 ],
            [ "roof_2x2_utilities_b", 15 ],
            [ "roof_2x2_utilities_c", 5 ],
            [ "roof_2x2_utilities_d", 40 ],
            [ "roof_2x2_utilities", 50 ],
            [ "roof_2x2_golf", 20 ],
            [ "roof_3x3_wine", 30 ]
          ],
          "x": [ 3, 17 ],
          "y": [ 4, 7 ]
        },
        {
          "chunks": [
            [ "null", 20 ],
            [ "roof_4x4_party", 15 ],
            [ "roof_4x4_utility", 40 ],
            [ "roof_4x4_utility_1", 30 ],
            [ "roof_6x6_utility", 20 ]
          ],
          "x": [ 3, 15 ],
          "y": [ 10, 14 ]
        }
      ]
    }
  }
]
