[
  {
    "type": "mapgen",
    "method": "json",
    "om_terrain": [ [ "lumberyard_0_0", "lumberyard_1_0" ], [ "lumberyard_0_1", "lumberyard_1_1" ] ],
    "weight": 100,
    "object": {
      "fill_ter": "t_grass",
      "rows": [
        "vvvvvvvvvvvvvvvvvvv  ______  vvvvvvvvvvvvvvvvvvv",
        "v  *         *      *______ *      2      *    v",
        "v      *       2     ______   7               2v",
        "v                    ______         *   2      v",
        "v*2      7 *    *    ______     *            * v",
        "v *###ww####ww### * ________  *   ##ww#ww##    v",
        "v  #xx..........#   __________    w.c...c.w   *v",
        "v  #xx..........;_________________#ddX.Xdd#*   v",
        "v* wx...........;_________________+.......#  * v",
        "v  w............;_________________#......&#    v",
        "v  #x...........;____________ 2 * #ddX.Xdd#7   v",
        "v 2#xx..........;____________     w.c....cw   *v",
        "v *#.x@=====@x.6#6  __________*   #########    v",
        "v  #..x..xx...xx# 2 __________  *     *     *  V",
        "v  #x.@=====@.x6#6 *__________  2############# v",
        "v *#xx..........;________________#&.bb.bb.C.f# v",
        "v  #xx..........;________________+..TT.TT.C.f#*v",
        "v* wx...........;________________#..bb.bb.C.D# v",
        "v  wx...........;_____________   #..........F#7v",
        "v  #............;_____________  *#....Tc###### v",
        "v 7#xx.....x..xx#  __________ *  wbTb.Tc#S.+t#*v",
        "#######+#########7 __________   2wbTb...+..### v",
        "#$.$#ll.ll#b.w    *___________   #......#S.+t#*v",
        "#$.$#.....#b.#__________________*###ww######## v",
        "#$..+.bbb.+..+___________________________   *  v",
        "#$.$#.....#b.#______________________________  *v",
        "#$.$#lllll#b.w   _____________________________ v",
        "##############   _____________________________ v",
        "v 2              ______________________________v",
        "v    1111 11111  ______________________________v",
        "v   *          * ______________________________v",
        "v  1111 11111    ______________________________v",
        "v               _______________________________v",
        "v 111111 11111  _______________________________v",
        "v *             ______________________________ v",
        "v  111111 111  _______________________________ v",
        "v        2    ______________________________   v",
        "v vvvvvv   *___________________________1 1   1*v",
        "v v____v_____________________   ____ 121   1   v",
        "v v____V____________ #.......#  ____ 1 1*1 1 1 v",
        "v v____v________     #L.....L#* ____*  1 1 1 2 v",
        "v vvvvvv  ______  * *wL.....Lw   ____1 1 1 1  *v",
        "v         1____ 2    #L.....L# * ____1 1*  1   v",
        "v 1111111 1____    7 wx....xxw   ____       *  v",
        "v1         ____*     #xx.x.xx#   ____ *111111  v",
        "v1 1111111____    2  #########*   ____   2   7 v",
        "v1   2    ____      *    2        ____    *   *v",
        "vvvvvvvvvvvvvvvvvvvvvvvvvvvvvvvvvvvvvvvvvvvvvvvv"
      ],
      "palettes": [ "lumberyard" ],
      "place_terrain": [ { "ter": "t_gas_tank", "x": 4, "y": 39 } ],
      "place_liquids": [ { "liquid": "gasoline", "x": 4, "y": 39, "repeat": [ 200, 1075 ] } ],
      "place_vehicles": [
        { "vehicle": "flatbed_truck", "x": [ 43, 45 ], "y": 33, "chance": 30, "fuel": 25, "status": 1, "rotation": 90 },
        {
          "vehicle": "pickup",
          "x": [ 35, 37 ],
          "y": [ 28, 31 ],
          "chance": 30,
          "fuel": 25,
          "status": 1,
          "rotation": 90
        },
        { "vehicle": "car", "x": [ 29, 31 ], "y": [ 27, 30 ], "chance": 30, "fuel": 15, "status": 1, "rotation": 90 }
      ]
    }
  },
  {
    "type": "mapgen",
    "method": "json",
    "om_terrain": [ "lumberyard_1_0" ],
    "weight": 50,
    "object": {
      "fill_ter": "t_grass",
      "rows": [
        "___ ###vvvvvvvvvvvvvvvvv",
        "___ wc#  *    2    *  2v",
        "___ #+#7 ##ww##ww##    v",
        "______   #.c....c.#  * v",
        "____   7 #ddX..ddX# 2  v",
        "____    ##.......&#*   v",
        "____ *  #.......#####  v",
        "_____   w.X.....#...# *v",
        "_____   wcd.Xdd.+.dcw  v",
        "_____  *#.d..c..#.dX#  v",
        "_____ #####+#########  v",
        "_____ #bbb..#t#t#mmm#* v",
        "______+.....#+#+#c..#  v",
        "______+.....#.S.#...#  v",
        "______#bbb..+...+..S#  v",
        "______#####+#####+### *v",
        "______ *#c...bbb..ff#  v",
        "______  wT...TTT....w* v",
        "_______ wc...bbb..FD# 2v",
        "_______ #&........###  v",
        "_______ ##bbb..bbb#  * v",
        "_______7 #TTT..TTT#    v",
        "_______  #bbb..bbb#*2  v",
        "_______7 ##ww##ww##    v"
      ],
      "palettes": [ "lumberyard" ]
    }
  }
]
